,Long,Lat,Width,Height,Goodness,geometry,id,LatMax,LongMax
0,-177,25,80,1,True,"Rectangle(xy=(-177, 25), width=80, height=1, angle=0)",0,26,-97
1,-97,25,16,1,True,"Rectangle(xy=(-97, 25), width=16, height=1, angle=0)",1,26,-81
2,-81,25,29,1,True,"Rectangle(xy=(-81, 25), width=29, height=1, angle=0)",2,26,-52
3,-177,26,79,1,True,"Rectangle(xy=(-177, 26), width=79, height=1, angle=0)",3,27,-98
4,-98,26,1,1,True,"Rectangle(xy=(-98, 26), width=1, height=1, angle=0)",4,27,-97
5,-97,26,15,1,True,"Rectangle(xy=(-97, 26), width=15, height=1, angle=0)",5,27,-82
6,-82,26,1,1,True,"Rectangle(xy=(-82, 26), width=1, height=1, angle=0)",6,27,-81
7,-81,26,29,1,True,"Rectangle(xy=(-81, 26), width=29, height=1, angle=0)",7,27,-52
8,-177,27,79,1,True,"Rectangle(xy=(-177, 27), width=79, height=1, angle=0)",8,28,-98
9,-98,27,1,1,True,"Rectangle(xy=(-98, 27), width=1, height=1, angle=0)",9,28,-97
10,-97,27,15,1,True,"Rectangle(xy=(-97, 27), width=15, height=1, angle=0)",10,28,-82
11,-82,27,1,1,True,"Rectangle(xy=(-82, 27), width=1, height=1, angle=0)",11,28,-81
12,-81,27,29,1,True,"Rectangle(xy=(-81, 27), width=29, height=1, angle=0)",12,28,-52
13,-177,28,78,1,True,"Rectangle(xy=(-177, 28), width=78, height=1, angle=0)",13,29,-99
14,-99,28,1,1,True,"Rectangle(xy=(-99, 28), width=1, height=1, angle=0)",14,29,-98
15,-98,28,1,1,True,"Rectangle(xy=(-98, 28), width=1, height=1, angle=0)",15,29,-97
16,-97,28,1,1,True,"Rectangle(xy=(-97, 28), width=1, height=1, angle=0)",16,29,-96
17,-96,28,1,1,True,"Rectangle(xy=(-96, 28), width=1, height=1, angle=0)",17,29,-95
18,-95,28,13,1,True,"Rectangle(xy=(-95, 28), width=13, height=1, angle=0)",18,29,-82
19,-82,28,1,1,True,"Rectangle(xy=(-82, 28), width=1, height=1, angle=0)",19,29,-81
20,-81,28,29,1,True,"Rectangle(xy=(-81, 28), width=29, height=1, angle=0)",20,29,-52
21,-177,29,78,1,True,"Rectangle(xy=(-177, 29), width=78, height=1, angle=0)",21,30,-99
22,-99,29,1,1,True,"Rectangle(xy=(-99, 29), width=1, height=1, angle=0)",22,30,-98
23,-98,29,1,1,True,"Rectangle(xy=(-98, 29), width=1, height=1, angle=0)",23,30,-97
24,-97,29,1,1,True,"Rectangle(xy=(-97, 29), width=1, height=1, angle=0)",24,30,-96
25,-96,29,1,1,True,"Rectangle(xy=(-96, 29), width=1, height=1, angle=0)",25,30,-95
26,-95,29,1,1,True,"Rectangle(xy=(-95, 29), width=1, height=1, angle=0)",26,30,-94
27,-94,29,12,1,True,"Rectangle(xy=(-94, 29), width=12, height=1, angle=0)",27,30,-82
28,-82,29,30,1,True,"Rectangle(xy=(-82, 29), width=30, height=1, angle=0)",28,30,-52
29,-177,30,74,1,True,"Rectangle(xy=(-177, 30), width=74, height=1, angle=0)",29,31,-103
30,-103,30,5,1,True,"Rectangle(xy=(-103, 30), width=5, height=1, angle=0)",30,31,-98
31,-98,30,1,1,True,"Rectangle(xy=(-98, 30), width=1, height=1, angle=0)",31,31,-97
32,-97,30,1,1,True,"Rectangle(xy=(-97, 30), width=1, height=1, angle=0)",32,31,-96
33,-96,30,2,1,True,"Rectangle(xy=(-96, 30), width=2, height=1, angle=0)",33,31,-94
34,-94,30,1,1,True,"Rectangle(xy=(-94, 30), width=1, height=1, angle=0)",34,31,-93
35,-93,30,5,1,True,"Rectangle(xy=(-93, 30), width=5, height=1, angle=0)",35,31,-88
36,-88,30,4,1,True,"Rectangle(xy=(-88, 30), width=4, height=1, angle=0)",36,31,-84
37,-84,30,1,1,True,"Rectangle(xy=(-84, 30), width=1, height=1, angle=0)",37,31,-83
38,-83,30,1,1,True,"Rectangle(xy=(-83, 30), width=1, height=1, angle=0)",38,31,-82
39,-82,30,30,1,True,"Rectangle(xy=(-82, 30), width=30, height=1, angle=0)",39,31,-52
40,-177,31,68,1,True,"Rectangle(xy=(-177, 31), width=68, height=1, angle=0)",40,32,-109
41,-109,31,2,1,True,"Rectangle(xy=(-109, 31), width=2, height=1, angle=0)",41,32,-107
42,-107,31,2,1,True,"Rectangle(xy=(-107, 31), width=2, height=1, angle=0)",42,32,-105
43,-105,31,4,1,True,"Rectangle(xy=(-105, 31), width=4, height=1, angle=0)",43,32,-101
44,-101,31,2,1,True,"Rectangle(xy=(-101, 31), width=2, height=1, angle=0)",44,32,-99
45,-99,31,2,1,True,"Rectangle(xy=(-99, 31), width=2, height=1, angle=0)",45,32,-97
46,-97,31,8,1,True,"Rectangle(xy=(-97, 31), width=8, height=1, angle=0)",46,32,-89
47,-89,31,5,1,True,"Rectangle(xy=(-89, 31), width=5, height=1, angle=0)",47,32,-84
48,-84,31,32,1,True,"Rectangle(xy=(-84, 31), width=32, height=1, angle=0)",48,32,-52
49,-177,32,65,1,True,"Rectangle(xy=(-177, 32), width=65, height=1, angle=0)",49,33,-112
50,-112,32,2,1,True,"Rectangle(xy=(-112, 32), width=2, height=1, angle=0)",50,33,-110
51,-110,32,1,1,True,"Rectangle(xy=(-110, 32), width=1, height=1, angle=0)",51,33,-109
52,-109,32,1,1,True,"Rectangle(xy=(-109, 32), width=1, height=1, angle=0)",52,33,-108
53,-108,32,1,1,True,"Rectangle(xy=(-108, 32), width=1, height=1, angle=0)",53,33,-107
54,-107,32,1,1,True,"Rectangle(xy=(-107, 32), width=1, height=1, angle=0)",54,33,-106
55,-106,32,2,1,True,"Rectangle(xy=(-106, 32), width=2, height=1, angle=0)",55,33,-104
56,-104,32,3,1,True,"Rectangle(xy=(-104, 32), width=3, height=1, angle=0)",56,33,-101
57,-101,32,1,1,True,"Rectangle(xy=(-101, 32), width=1, height=1, angle=0)",57,33,-100
58,-100,32,1,1,True,"Rectangle(xy=(-100, 32), width=1, height=1, angle=0)",58,33,-99
59,-99,32,1,1,True,"Rectangle(xy=(-99, 32), width=1, height=1, angle=0)",59,33,-98
60,-98,32,1,1,True,"Rectangle(xy=(-98, 32), width=1, height=1, angle=0)",60,33,-97
61,-97,32,8,1,True,"Rectangle(xy=(-97, 32), width=8, height=1, angle=0)",61,33,-89
62,-89,32,6,1,True,"Rectangle(xy=(-89, 32), width=6, height=1, angle=0)",62,33,-83
63,-83,32,31,1,True,"Rectangle(xy=(-83, 32), width=31, height=1, angle=0)",63,33,-52
64,-177,33,62,1,True,"Rectangle(xy=(-177, 33), width=62, height=1, angle=0)",64,34,-115
65,-115,33,1,1,True,"Rectangle(xy=(-115, 33), width=1, height=1, angle=0)",65,34,-114
66,-114,33,2,1,True,"Rectangle(xy=(-114, 33), width=2, height=1, angle=0)",66,34,-112
67,-112,33,4,1,True,"Rectangle(xy=(-112, 33), width=4, height=1, angle=0)",67,34,-108
68,-108,33,1,1,True,"Rectangle(xy=(-108, 33), width=1, height=1, angle=0)",68,34,-107
69,-107,33,1,1,True,"Rectangle(xy=(-107, 33), width=1, height=1, angle=0)",69,34,-106
70,-106,33,2,1,True,"Rectangle(xy=(-106, 33), width=2, height=1, angle=0)",70,34,-104
71,-104,33,2,1,True,"Rectangle(xy=(-104, 33), width=2, height=1, angle=0)",71,34,-102
72,-102,33,1,1,True,"Rectangle(xy=(-102, 33), width=1, height=1, angle=0)",72,34,-101
73,-101,33,2,1,True,"Rectangle(xy=(-101, 33), width=2, height=1, angle=0)",73,34,-99
74,-99,33,1,1,True,"Rectangle(xy=(-99, 33), width=1, height=1, angle=0)",74,34,-98
75,-98,33,2,1,True,"Rectangle(xy=(-98, 33), width=2, height=1, angle=0)",75,34,-96
76,-96,33,8,1,True,"Rectangle(xy=(-96, 33), width=8, height=1, angle=0)",76,34,-88
77,-88,33,4,1,True,"Rectangle(xy=(-88, 33), width=4, height=1, angle=0)",77,34,-84
78,-84,33,32,1,True,"Rectangle(xy=(-84, 33), width=32, height=1, angle=0)",78,34,-52
79,-177,34,67,1,True,"Rectangle(xy=(-177, 34), width=67, height=1, angle=0)",79,35,-110
80,-110,34,4,1,True,"Rectangle(xy=(-110, 34), width=4, height=1, angle=0)",80,35,-106
81,-106,34,3,1,True,"Rectangle(xy=(-106, 34), width=3, height=1, angle=0)",81,35,-103
82,-103,34,1,1,True,"Rectangle(xy=(-103, 34), width=1, height=1, angle=0)",82,35,-102
83,-102,34,1,1,True,"Rectangle(xy=(-102, 34), width=1, height=1, angle=0)",83,35,-101
84,-101,34,2,1,True,"Rectangle(xy=(-101, 34), width=2, height=1, angle=0)",84,35,-99
85,-99,34,1,1,True,"Rectangle(xy=(-99, 34), width=1, height=1, angle=0)",85,35,-98
86,-98,34,8,1,True,"Rectangle(xy=(-98, 34), width=8, height=1, angle=0)",86,35,-90
87,-90,34,4,1,True,"Rectangle(xy=(-90, 34), width=4, height=1, angle=0)",87,35,-86
88,-86,34,1,1,True,"Rectangle(xy=(-86, 34), width=1, height=1, angle=0)",88,35,-85
89,-85,34,1,1,True,"Rectangle(xy=(-85, 34), width=1, height=1, angle=0)",89,35,-84
90,-84,34,32,1,True,"Rectangle(xy=(-84, 34), width=32, height=1, angle=0)",90,35,-52
91,-177,35,58,1,True,"Rectangle(xy=(-177, 35), width=58, height=1, angle=0)",91,36,-119
92,-119,35,13,1,True,"Rectangle(xy=(-119, 35), width=13, height=1, angle=0)",92,36,-106
93,-106,35,1,1,True,"Rectangle(xy=(-106, 35), width=1, height=1, angle=0)",93,36,-105
94,-105,35,4,1,True,"Rectangle(xy=(-105, 35), width=4, height=1, angle=0)",94,36,-101
95,-101,35,3,1,True,"Rectangle(xy=(-101, 35), width=3, height=1, angle=0)",95,36,-98
96,-98,35,11,1,True,"Rectangle(xy=(-98, 35), width=11, height=1, angle=0)",96,36,-87
97,-87,35,1,1,True,"Rectangle(xy=(-87, 35), width=1, height=1, angle=0)",97,36,-86
98,-86,35,1,1,True,"Rectangle(xy=(-86, 35), width=1, height=1, angle=0)",98,36,-85
99,-85,35,1,1,True,"Rectangle(xy=(-85, 35), width=1, height=1, angle=0)",99,36,-84
100,-84,35,32,1,True,"Rectangle(xy=(-84, 35), width=32, height=1, angle=0)",100,36,-52
101,-177,36,64,1,True,"Rectangle(xy=(-177, 36), width=64, height=1, angle=0)",101,37,-113
102,-113,36,7,1,True,"Rectangle(xy=(-113, 36), width=7, height=1, angle=0)",102,37,-106
103,-106,36,2,1,True,"Rectangle(xy=(-106, 36), width=2, height=1, angle=0)",103,37,-104
104,-104,36,4,1,True,"Rectangle(xy=(-104, 36), width=4, height=1, angle=0)",104,37,-100
105,-100,36,1,1,True,"Rectangle(xy=(-100, 36), width=1, height=1, angle=0)",105,37,-99
106,-99,36,1,1,True,"Rectangle(xy=(-99, 36), width=1, height=1, angle=0)",106,37,-98
107,-98,36,10,1,True,"Rectangle(xy=(-98, 36), width=10, height=1, angle=0)",107,37,-88
108,-88,36,1,1,True,"Rectangle(xy=(-88, 36), width=1, height=1, angle=0)",108,37,-87
109,-87,36,1,1,True,"Rectangle(xy=(-87, 36), width=1, height=1, angle=0)",109,37,-86
110,-86,36,1,1,True,"Rectangle(xy=(-86, 36), width=1, height=1, angle=0)",110,37,-85
111,-85,36,2,1,True,"Rectangle(xy=(-85, 36), width=2, height=1, angle=0)",111,37,-83
112,-83,36,31,1,True,"Rectangle(xy=(-83, 36), width=31, height=1, angle=0)",112,37,-52
113,-177,37,56,1,True,"Rectangle(xy=(-177, 37), width=56, height=1, angle=0)",113,38,-121
114,-121,37,1,1,True,"Rectangle(xy=(-121, 37), width=1, height=1, angle=0)",114,38,-120
115,-120,37,12,1,True,"Rectangle(xy=(-120, 37), width=12, height=1, angle=0)",115,38,-108
116,-108,37,2,1,True,"Rectangle(xy=(-108, 37), width=2, height=1, angle=0)",116,38,-106
117,-106,37,1,1,True,"Rectangle(xy=(-106, 37), width=1, height=1, angle=0)",117,38,-105
118,-105,37,4,1,True,"Rectangle(xy=(-105, 37), width=4, height=1, angle=0)",118,38,-101
119,-101,37,2,1,True,"Rectangle(xy=(-101, 37), width=2, height=1, angle=0)",119,38,-99
120,-99,37,1,1,True,"Rectangle(xy=(-99, 37), width=1, height=1, angle=0)",120,38,-98
121,-98,37,11,1,True,"Rectangle(xy=(-98, 37), width=11, height=1, angle=0)",121,38,-87
122,-87,37,1,1,True,"Rectangle(xy=(-87, 37), width=1, height=1, angle=0)",122,38,-86
123,-86,37,1,1,True,"Rectangle(xy=(-86, 37), width=1, height=1, angle=0)",123,38,-85
124,-85,37,33,1,True,"Rectangle(xy=(-85, 37), width=33, height=1, angle=0)",124,38,-52
125,-177,38,55,1,True,"Rectangle(xy=(-177, 38), width=55, height=1, angle=0)",125,39,-122
126,-122,38,1,1,True,"Rectangle(xy=(-122, 38), width=1, height=1, angle=0)",126,39,-121
127,-121,38,2,1,True,"Rectangle(xy=(-121, 38), width=2, height=1, angle=0)",127,39,-119
128,-119,38,7,1,True,"Rectangle(xy=(-119, 38), width=7, height=1, angle=0)",128,39,-112
129,-112,38,1,1,True,"Rectangle(xy=(-112, 38), width=1, height=1, angle=0)",129,39,-111
130,-111,38,2,1,True,"Rectangle(xy=(-111, 38), width=2, height=1, angle=0)",130,39,-109
131,-109,38,1,1,True,"Rectangle(xy=(-109, 38), width=1, height=1, angle=0)",131,39,-108
132,-108,38,1,1,True,"Rectangle(xy=(-108, 38), width=1, height=1, angle=0)",132,39,-107
133,-107,38,1,1,True,"Rectangle(xy=(-107, 38), width=1, height=1, angle=0)",133,39,-106
134,-106,38,1,1,True,"Rectangle(xy=(-106, 38), width=1, height=1, angle=0)",134,39,-105
135,-105,38,1,1,True,"Rectangle(xy=(-105, 38), width=1, height=1, angle=0)",135,39,-104
136,-104,38,1,1,True,"Rectangle(xy=(-104, 38), width=1, height=1, angle=0)",136,39,-103
137,-103,38,1,1,True,"Rectangle(xy=(-103, 38), width=1, height=1, angle=0)",137,39,-102
138,-102,38,4,1,True,"Rectangle(xy=(-102, 38), width=4, height=1, angle=0)",138,39,-98
139,-98,38,8,1,True,"Rectangle(xy=(-98, 38), width=8, height=1, angle=0)",139,39,-90
140,-90,38,3,1,True,"Rectangle(xy=(-90, 38), width=3, height=1, angle=0)",140,39,-87
141,-87,38,1,1,True,"Rectangle(xy=(-87, 38), width=1, height=1, angle=0)",141,39,-86
142,-86,38,1,1,True,"Rectangle(xy=(-86, 38), width=1, height=1, angle=0)",142,39,-85
143,-85,38,7,1,True,"Rectangle(xy=(-85, 38), width=7, height=1, angle=0)",143,39,-78
144,-78,38,26,1,True,"Rectangle(xy=(-78, 38), width=26, height=1, angle=0)",144,39,-52
145,-177,39,55,1,True,"Rectangle(xy=(-177, 39), width=55, height=1, angle=0)",145,40,-122
146,-122,39,1,1,True,"Rectangle(xy=(-122, 39), width=1, height=1, angle=0)",146,40,-121
147,-121,39,1,1,True,"Rectangle(xy=(-121, 39), width=1, height=1, angle=0)",147,40,-120
148,-120,39,1,1,True,"Rectangle(xy=(-120, 39), width=1, height=1, angle=0)",148,40,-119
149,-119,39,8,1,True,"Rectangle(xy=(-119, 39), width=8, height=1, angle=0)",149,40,-111
150,-111,39,2,1,True,"Rectangle(xy=(-111, 39), width=2, height=1, angle=0)",150,40,-109
151,-109,39,1,1,True,"Rectangle(xy=(-109, 39), width=1, height=1, angle=0)",151,40,-108
152,-108,39,1,1,True,"Rectangle(xy=(-108, 39), width=1, height=1, angle=0)",152,40,-107
153,-107,39,2,1,True,"Rectangle(xy=(-107, 39), width=2, height=1, angle=0)",153,40,-105
154,-105,39,1,1,True,"Rectangle(xy=(-105, 39), width=1, height=1, angle=0)",154,40,-104
155,-104,39,4,1,True,"Rectangle(xy=(-104, 39), width=4, height=1, angle=0)",155,40,-100
156,-100,39,8,1,True,"Rectangle(xy=(-100, 39), width=8, height=1, angle=0)",156,40,-92
157,-92,39,2,1,True,"Rectangle(xy=(-92, 39), width=2, height=1, angle=0)",157,40,-90
158,-90,39,3,1,True,"Rectangle(xy=(-90, 39), width=3, height=1, angle=0)",158,40,-87
159,-87,39,1,1,True,"Rectangle(xy=(-87, 39), width=1, height=1, angle=0)",159,40,-86
160,-86,39,1,1,True,"Rectangle(xy=(-86, 39), width=1, height=1, angle=0)",160,40,-85
161,-85,39,1,1,True,"Rectangle(xy=(-85, 39), width=1, height=1, angle=0)",161,40,-84
162,-84,39,1,1,True,"Rectangle(xy=(-84, 39), width=1, height=1, angle=0)",162,40,-83
163,-83,39,1,1,True,"Rectangle(xy=(-83, 39), width=1, height=1, angle=0)",163,40,-82
164,-82,39,3,1,True,"Rectangle(xy=(-82, 39), width=3, height=1, angle=0)",164,40,-79
165,-79,39,2,1,True,"Rectangle(xy=(-79, 39), width=2, height=1, angle=0)",165,40,-77
166,-77,39,1,1,True,"Rectangle(xy=(-77, 39), width=1, height=1, angle=0)",166,40,-76
167,-76,39,24,1,True,"Rectangle(xy=(-76, 39), width=24, height=1, angle=0)",167,40,-52
168,-177,40,56,1,True,"Rectangle(xy=(-177, 40), width=56, height=1, angle=0)",168,41,-121
169,-121,40,1,1,True,"Rectangle(xy=(-121, 40), width=1, height=1, angle=0)",169,41,-120
170,-120,40,5,1,True,"Rectangle(xy=(-120, 40), width=5, height=1, angle=0)",170,41,-115
171,-115,40,3,1,True,"Rectangle(xy=(-115, 40), width=3, height=1, angle=0)",171,41,-112
172,-112,40,1,1,True,"Rectangle(xy=(-112, 40), width=1, height=1, angle=0)",172,41,-111
173,-111,40,1,1,True,"Rectangle(xy=(-111, 40), width=1, height=1, angle=0)",173,41,-110
174,-110,40,1,1,True,"Rectangle(xy=(-110, 40), width=1, height=1, angle=0)",174,41,-109
175,-109,40,2,1,True,"Rectangle(xy=(-109, 40), width=2, height=1, angle=0)",175,41,-107
176,-107,40,1,1,True,"Rectangle(xy=(-107, 40), width=1, height=1, angle=0)",176,41,-106
177,-106,40,1,1,True,"Rectangle(xy=(-106, 40), width=1, height=1, angle=0)",177,41,-105
178,-105,40,1,1,True,"Rectangle(xy=(-105, 40), width=1, height=1, angle=0)",178,41,-104
179,-104,40,2,1,True,"Rectangle(xy=(-104, 40), width=2, height=1, angle=0)",179,41,-102
180,-102,40,3,1,True,"Rectangle(xy=(-102, 40), width=3, height=1, angle=0)",180,41,-99
181,-99,40,1,1,True,"Rectangle(xy=(-99, 40), width=1, height=1, angle=0)",181,41,-98
182,-98,40,3,1,True,"Rectangle(xy=(-98, 40), width=3, height=1, angle=0)",182,41,-95
183,-95,40,8,1,True,"Rectangle(xy=(-95, 40), width=8, height=1, angle=0)",183,41,-87
184,-87,40,1,1,True,"Rectangle(xy=(-87, 40), width=1, height=1, angle=0)",184,41,-86
185,-86,40,1,1,True,"Rectangle(xy=(-86, 40), width=1, height=1, angle=0)",185,41,-85
186,-85,40,1,1,True,"Rectangle(xy=(-85, 40), width=1, height=1, angle=0)",186,41,-84
187,-84,40,1,1,True,"Rectangle(xy=(-84, 40), width=1, height=1, angle=0)",187,41,-83
188,-83,40,1,1,True,"Rectangle(xy=(-83, 40), width=1, height=1, angle=0)",188,41,-82
189,-82,40,1,1,True,"Rectangle(xy=(-82, 40), width=1, height=1, angle=0)",189,41,-81
190,-81,40,1,1,True,"Rectangle(xy=(-81, 40), width=1, height=1, angle=0)",190,41,-80
191,-80,40,4,1,True,"Rectangle(xy=(-80, 40), width=4, height=1, angle=0)",191,41,-76
192,-76,40,1,1,True,"Rectangle(xy=(-76, 40), width=1, height=1, angle=0)",192,41,-75
193,-75,40,1,1,True,"Rectangle(xy=(-75, 40), width=1, height=1, angle=0)",193,41,-74
194,-74,40,22,1,True,"Rectangle(xy=(-74, 40), width=22, height=1, angle=0)",194,41,-52
195,-177,41,55,1,True,"Rectangle(xy=(-177, 41), width=55, height=1, angle=0)",195,42,-122
196,-122,41,1,1,True,"Rectangle(xy=(-122, 41), width=1, height=1, angle=0)",196,42,-121
197,-121,41,1,1,True,"Rectangle(xy=(-121, 41), width=1, height=1, angle=0)",197,42,-120
198,-120,41,8,1,True,"Rectangle(xy=(-120, 41), width=8, height=1, angle=0)",198,42,-112
199,-112,41,1,1,True,"Rectangle(xy=(-112, 41), width=1, height=1, angle=0)",199,42,-111
200,-111,41,1,1,True,"Rectangle(xy=(-111, 41), width=1, height=1, angle=0)",200,42,-110
201,-110,41,1,1,True,"Rectangle(xy=(-110, 41), width=1, height=1, angle=0)",201,42,-109
202,-109,41,2,1,True,"Rectangle(xy=(-109, 41), width=2, height=1, angle=0)",202,42,-107
203,-107,41,1,1,True,"Rectangle(xy=(-107, 41), width=1, height=1, angle=0)",203,42,-106
204,-106,41,1,1,True,"Rectangle(xy=(-106, 41), width=1, height=1, angle=0)",204,42,-105
205,-105,41,1,1,True,"Rectangle(xy=(-105, 41), width=1, height=1, angle=0)",205,42,-104
206,-104,41,1,1,True,"Rectangle(xy=(-104, 41), width=1, height=1, angle=0)",206,42,-103
207,-103,41,2,1,True,"Rectangle(xy=(-103, 41), width=2, height=1, angle=0)",207,42,-101
208,-101,41,1,1,True,"Rectangle(xy=(-101, 41), width=1, height=1, angle=0)",208,42,-100
209,-100,41,4,1,True,"Rectangle(xy=(-100, 41), width=4, height=1, angle=0)",209,42,-96
210,-96,41,3,1,True,"Rectangle(xy=(-96, 41), width=3, height=1, angle=0)",210,42,-93
211,-93,41,1,1,True,"Rectangle(xy=(-93, 41), width=1, height=1, angle=0)",211,42,-92
212,-92,41,1,1,True,"Rectangle(xy=(-92, 41), width=1, height=1, angle=0)",212,42,-91
213,-91,41,1,1,True,"Rectangle(xy=(-91, 41), width=1, height=1, angle=0)",213,42,-90
214,-90,41,1,1,True,"Rectangle(xy=(-90, 41), width=1, height=1, angle=0)",214,42,-89
215,-89,41,1,1,True,"Rectangle(xy=(-89, 41), width=1, height=1, angle=0)",215,42,-88
216,-88,41,1,1,True,"Rectangle(xy=(-88, 41), width=1, height=1, angle=0)",216,42,-87
217,-87,41,1,1,True,"Rectangle(xy=(-87, 41), width=1, height=1, angle=0)",217,42,-86
218,-86,41,1,1,True,"Rectangle(xy=(-86, 41), width=1, height=1, angle=0)",218,42,-85
219,-85,41,1,1,True,"Rectangle(xy=(-85, 41), width=1, height=1, angle=0)",219,42,-84
220,-84,41,1,1,True,"Rectangle(xy=(-84, 41), width=1, height=1, angle=0)",220,42,-83
221,-83,41,1,1,True,"Rectangle(xy=(-83, 41), width=1, height=1, angle=0)",221,42,-82
222,-82,41,1,1,True,"Rectangle(xy=(-82, 41), width=1, height=1, angle=0)",222,42,-81
223,-81,41,1,1,True,"Rectangle(xy=(-81, 41), width=1, height=1, angle=0)",223,42,-80
224,-80,41,1,1,True,"Rectangle(xy=(-80, 41), width=1, height=1, angle=0)",224,42,-79
225,-79,41,3,1,True,"Rectangle(xy=(-79, 41), width=3, height=1, angle=0)",225,42,-76
226,-76,41,2,1,True,"Rectangle(xy=(-76, 41), width=2, height=1, angle=0)",226,42,-74
227,-74,41,2,1,True,"Rectangle(xy=(-74, 41), width=2, height=1, angle=0)",227,42,-72
228,-72,41,1,1,True,"Rectangle(xy=(-72, 41), width=1, height=1, angle=0)",228,42,-71
229,-71,41,19,1,True,"Rectangle(xy=(-71, 41), width=19, height=1, angle=0)",229,42,-52
230,-177,42,55,1,True,"Rectangle(xy=(-177, 42), width=55, height=1, angle=0)",230,43,-122
231,-122,42,1,1,True,"Rectangle(xy=(-122, 42), width=1, height=1, angle=0)",231,43,-121
232,-121,42,1,1,True,"Rectangle(xy=(-121, 42), width=1, height=1, angle=0)",232,43,-120
233,-120,42,1,1,True,"Rectangle(xy=(-120, 42), width=1, height=1, angle=0)",233,43,-119
234,-119,42,1,1,True,"Rectangle(xy=(-119, 42), width=1, height=1, angle=0)",234,43,-118
235,-118,42,1,1,True,"Rectangle(xy=(-118, 42), width=1, height=1, angle=0)",235,43,-117
236,-117,42,1,1,True,"Rectangle(xy=(-117, 42), width=1, height=1, angle=0)",236,43,-116
237,-116,42,2,1,True,"Rectangle(xy=(-116, 42), width=2, height=1, angle=0)",237,43,-114
238,-114,42,1,1,True,"Rectangle(xy=(-114, 42), width=1, height=1, angle=0)",238,43,-113
239,-113,42,1,1,True,"Rectangle(xy=(-113, 42), width=1, height=1, angle=0)",239,43,-112
240,-112,42,1,1,True,"Rectangle(xy=(-112, 42), width=1, height=1, angle=0)",240,43,-111
241,-111,42,1,1,True,"Rectangle(xy=(-111, 42), width=1, height=1, angle=0)",241,43,-110
242,-110,42,1,1,True,"Rectangle(xy=(-110, 42), width=1, height=1, angle=0)",242,43,-109
243,-109,42,1,1,True,"Rectangle(xy=(-109, 42), width=1, height=1, angle=0)",243,43,-108
244,-108,42,2,1,True,"Rectangle(xy=(-108, 42), width=2, height=1, angle=0)",244,43,-106
245,-106,42,1,1,True,"Rectangle(xy=(-106, 42), width=1, height=1, angle=0)",245,43,-105
246,-105,42,8,1,True,"Rectangle(xy=(-105, 42), width=8, height=1, angle=0)",246,43,-97
247,-97,42,4,1,True,"Rectangle(xy=(-97, 42), width=4, height=1, angle=0)",247,43,-93
248,-93,42,1,1,True,"Rectangle(xy=(-93, 42), width=1, height=1, angle=0)",248,43,-92
249,-92,42,1,1,True,"Rectangle(xy=(-92, 42), width=1, height=1, angle=0)",249,43,-91
250,-91,42,1,1,True,"Rectangle(xy=(-91, 42), width=1, height=1, angle=0)",250,43,-90
251,-90,42,1,1,True,"Rectangle(xy=(-90, 42), width=1, height=1, angle=0)",251,43,-89
252,-89,42,1,1,True,"Rectangle(xy=(-89, 42), width=1, height=1, angle=0)",252,43,-88
253,-88,42,1,1,True,"Rectangle(xy=(-88, 42), width=1, height=1, angle=0)",253,43,-87
254,-87,42,1,1,True,"Rectangle(xy=(-87, 42), width=1, height=1, angle=0)",254,43,-86
255,-86,42,1,1,True,"Rectangle(xy=(-86, 42), width=1, height=1, angle=0)",255,43,-85
256,-85,42,1,1,True,"Rectangle(xy=(-85, 42), width=1, height=1, angle=0)",256,43,-84
257,-84,42,1,1,True,"Rectangle(xy=(-84, 42), width=1, height=1, angle=0)",257,43,-83
258,-83,42,1,1,True,"Rectangle(xy=(-83, 42), width=1, height=1, angle=0)",258,43,-82
259,-82,42,1,1,True,"Rectangle(xy=(-82, 42), width=1, height=1, angle=0)",259,43,-81
260,-81,42,1,1,True,"Rectangle(xy=(-81, 42), width=1, height=1, angle=0)",260,43,-80
261,-80,42,1,1,True,"Rectangle(xy=(-80, 42), width=1, height=1, angle=0)",261,43,-79
262,-79,42,2,1,True,"Rectangle(xy=(-79, 42), width=2, height=1, angle=0)",262,43,-77
263,-77,42,1,1,True,"Rectangle(xy=(-77, 42), width=1, height=1, angle=0)",263,43,-76
264,-76,42,1,1,True,"Rectangle(xy=(-76, 42), width=1, height=1, angle=0)",264,43,-75
265,-75,42,2,1,True,"Rectangle(xy=(-75, 42), width=2, height=1, angle=0)",265,43,-73
266,-73,42,1,1,True,"Rectangle(xy=(-73, 42), width=1, height=1, angle=0)",266,43,-72
267,-72,42,1,1,True,"Rectangle(xy=(-72, 42), width=1, height=1, angle=0)",267,43,-71
268,-71,42,19,1,True,"Rectangle(xy=(-71, 42), width=19, height=1, angle=0)",268,43,-52
269,-177,43,56,1,True,"Rectangle(xy=(-177, 43), width=56, height=1, angle=0)",269,44,-121
270,-121,43,2,1,True,"Rectangle(xy=(-121, 43), width=2, height=1, angle=0)",270,44,-119
271,-119,43,1,1,True,"Rectangle(xy=(-119, 43), width=1, height=1, angle=0)",271,44,-118
272,-118,43,1,1,True,"Rectangle(xy=(-118, 43), width=1, height=1, angle=0)",272,44,-117
273,-117,43,1,1,True,"Rectangle(xy=(-117, 43), width=1, height=1, angle=0)",273,44,-116
274,-116,43,1,1,True,"Rectangle(xy=(-116, 43), width=1, height=1, angle=0)",274,44,-115
275,-115,43,1,1,True,"Rectangle(xy=(-115, 43), width=1, height=1, angle=0)",275,44,-114
276,-114,43,1,1,True,"Rectangle(xy=(-114, 43), width=1, height=1, angle=0)",276,44,-113
277,-113,43,1,1,True,"Rectangle(xy=(-113, 43), width=1, height=1, angle=0)",277,44,-112
278,-112,43,1,1,True,"Rectangle(xy=(-112, 43), width=1, height=1, angle=0)",278,44,-111
279,-111,43,1,1,True,"Rectangle(xy=(-111, 43), width=1, height=1, angle=0)",279,44,-110
280,-110,43,2,1,True,"Rectangle(xy=(-110, 43), width=2, height=1, angle=0)",280,44,-108
281,-108,43,2,1,True,"Rectangle(xy=(-108, 43), width=2, height=1, angle=0)",281,44,-106
282,-106,43,8,1,True,"Rectangle(xy=(-106, 43), width=8, height=1, angle=0)",282,44,-98
283,-98,43,4,1,True,"Rectangle(xy=(-98, 43), width=4, height=1, angle=0)",283,44,-94
284,-94,43,1,1,True,"Rectangle(xy=(-94, 43), width=1, height=1, angle=0)",284,44,-93
285,-93,43,1,1,True,"Rectangle(xy=(-93, 43), width=1, height=1, angle=0)",285,44,-92
286,-92,43,1,1,True,"Rectangle(xy=(-92, 43), width=1, height=1, angle=0)",286,44,-91
287,-91,43,1,1,True,"Rectangle(xy=(-91, 43), width=1, height=1, angle=0)",287,44,-90
288,-90,43,1,1,True,"Rectangle(xy=(-90, 43), width=1, height=1, angle=0)",288,44,-89
289,-89,43,1,1,True,"Rectangle(xy=(-89, 43), width=1, height=1, angle=0)",289,44,-88
290,-88,43,1,1,True,"Rectangle(xy=(-88, 43), width=1, height=1, angle=0)",290,44,-87
291,-87,43,1,1,True,"Rectangle(xy=(-87, 43), width=1, height=1, angle=0)",291,44,-86
292,-86,43,1,1,True,"Rectangle(xy=(-86, 43), width=1, height=1, angle=0)",292,44,-85
293,-85,43,1,1,True,"Rectangle(xy=(-85, 43), width=1, height=1, angle=0)",293,44,-84
294,-84,43,1,1,True,"Rectangle(xy=(-84, 43), width=1, height=1, angle=0)",294,44,-83
295,-83,43,1,1,True,"Rectangle(xy=(-83, 43), width=1, height=1, angle=0)",295,44,-82
296,-82,43,1,1,True,"Rectangle(xy=(-82, 43), width=1, height=1, angle=0)",296,44,-81
297,-81,43,1,1,True,"Rectangle(xy=(-81, 43), width=1, height=1, angle=0)",297,44,-80
298,-80,43,1,1,True,"Rectangle(xy=(-80, 43), width=1, height=1, angle=0)",298,44,-79
299,-79,43,1,1,True,"Rectangle(xy=(-79, 43), width=1, height=1, angle=0)",299,44,-78
300,-78,43,1,1,True,"Rectangle(xy=(-78, 43), width=1, height=1, angle=0)",300,44,-77
301,-77,43,1,1,True,"Rectangle(xy=(-77, 43), width=1, height=1, angle=0)",301,44,-76
302,-76,43,24,1,True,"Rectangle(xy=(-76, 43), width=24, height=1, angle=0)",302,44,-52
303,-177,44,54,1,True,"Rectangle(xy=(-177, 44), width=54, height=1, angle=0)",303,45,-123
304,-123,44,2,1,True,"Rectangle(xy=(-123, 44), width=2, height=1, angle=0)",304,45,-121
305,-121,44,2,1,True,"Rectangle(xy=(-121, 44), width=2, height=1, angle=0)",305,45,-119
306,-119,44,1,1,True,"Rectangle(xy=(-119, 44), width=1, height=1, angle=0)",306,45,-118
307,-118,44,2,1,True,"Rectangle(xy=(-118, 44), width=2, height=1, angle=0)",307,45,-116
308,-116,44,1,1,True,"Rectangle(xy=(-116, 44), width=1, height=1, angle=0)",308,45,-115
309,-115,44,1,1,True,"Rectangle(xy=(-115, 44), width=1, height=1, angle=0)",309,45,-114
310,-114,44,1,1,True,"Rectangle(xy=(-114, 44), width=1, height=1, angle=0)",310,45,-113
311,-113,44,1,1,True,"Rectangle(xy=(-113, 44), width=1, height=1, angle=0)",311,45,-112
312,-112,44,1,1,True,"Rectangle(xy=(-112, 44), width=1, height=1, angle=0)",312,45,-111
313,-111,44,1,1,True,"Rectangle(xy=(-111, 44), width=1, height=1, angle=0)",313,45,-110
314,-110,44,1,1,True,"Rectangle(xy=(-110, 44), width=1, height=1, angle=0)",314,45,-109
315,-109,44,1,1,True,"Rectangle(xy=(-109, 44), width=1, height=1, angle=0)",315,45,-108
316,-108,44,1,1,True,"Rectangle(xy=(-108, 44), width=1, height=1, angle=0)",316,45,-107
317,-107,44,1,1,True,"Rectangle(xy=(-107, 44), width=1, height=1, angle=0)",317,45,-106
318,-106,44,4,1,True,"Rectangle(xy=(-106, 44), width=4, height=1, angle=0)",318,45,-102
319,-102,44,8,1,True,"Rectangle(xy=(-102, 44), width=8, height=1, angle=0)",319,45,-94
320,-94,44,1,1,True,"Rectangle(xy=(-94, 44), width=1, height=1, angle=0)",320,45,-93
321,-93,44,1,1,True,"Rectangle(xy=(-93, 44), width=1, height=1, angle=0)",321,45,-92
322,-92,44,1,1,True,"Rectangle(xy=(-92, 44), width=1, height=1, angle=0)",322,45,-91
323,-91,44,1,1,True,"Rectangle(xy=(-91, 44), width=1, height=1, angle=0)",323,45,-90
324,-90,44,1,1,True,"Rectangle(xy=(-90, 44), width=1, height=1, angle=0)",324,45,-89
325,-89,44,1,1,True,"Rectangle(xy=(-89, 44), width=1, height=1, angle=0)",325,45,-88
326,-88,44,1,1,True,"Rectangle(xy=(-88, 44), width=1, height=1, angle=0)",326,45,-87
327,-87,44,1,1,True,"Rectangle(xy=(-87, 44), width=1, height=1, angle=0)",327,45,-86
328,-86,44,1,1,True,"Rectangle(xy=(-86, 44), width=1, height=1, angle=0)",328,45,-85
329,-85,44,1,1,True,"Rectangle(xy=(-85, 44), width=1, height=1, angle=0)",329,45,-84
330,-84,44,1,1,True,"Rectangle(xy=(-84, 44), width=1, height=1, angle=0)",330,45,-83
331,-83,44,2,1,True,"Rectangle(xy=(-83, 44), width=2, height=1, angle=0)",331,45,-81
332,-81,44,1,1,True,"Rectangle(xy=(-81, 44), width=1, height=1, angle=0)",332,45,-80
333,-80,44,1,1,True,"Rectangle(xy=(-80, 44), width=1, height=1, angle=0)",333,45,-79
334,-79,44,1,1,True,"Rectangle(xy=(-79, 44), width=1, height=1, angle=0)",334,45,-78
335,-78,44,1,1,True,"Rectangle(xy=(-78, 44), width=1, height=1, angle=0)",335,45,-77
336,-77,44,1,1,True,"Rectangle(xy=(-77, 44), width=1, height=1, angle=0)",336,45,-76
337,-76,44,1,1,True,"Rectangle(xy=(-76, 44), width=1, height=1, angle=0)",337,45,-75
338,-75,44,1,1,True,"Rectangle(xy=(-75, 44), width=1, height=1, angle=0)",338,45,-74
339,-74,44,1,1,True,"Rectangle(xy=(-74, 44), width=1, height=1, angle=0)",339,45,-73
340,-73,44,1,1,True,"Rectangle(xy=(-73, 44), width=1, height=1, angle=0)",340,45,-72
341,-72,44,2,1,True,"Rectangle(xy=(-72, 44), width=2, height=1, angle=0)",341,45,-70
342,-70,44,18,1,True,"Rectangle(xy=(-70, 44), width=18, height=1, angle=0)",342,45,-52
343,-177,45,55,1,True,"Rectangle(xy=(-177, 45), width=55, height=1, angle=0)",343,46,-122
344,-122,45,1,1,True,"Rectangle(xy=(-122, 45), width=1, height=1, angle=0)",344,46,-121
345,-121,45,2,1,True,"Rectangle(xy=(-121, 45), width=2, height=1, angle=0)",345,46,-119
346,-119,45,1,1,True,"Rectangle(xy=(-119, 45), width=1, height=1, angle=0)",346,46,-118
347,-118,45,1,1,True,"Rectangle(xy=(-118, 45), width=1, height=1, angle=0)",347,46,-117
348,-117,45,4,1,True,"Rectangle(xy=(-117, 45), width=4, height=1, angle=0)",348,46,-113
349,-113,45,1,1,True,"Rectangle(xy=(-113, 45), width=1, height=1, angle=0)",349,46,-112
350,-112,45,1,1,True,"Rectangle(xy=(-112, 45), width=1, height=1, angle=0)",350,46,-111
351,-111,45,1,1,True,"Rectangle(xy=(-111, 45), width=1, height=1, angle=0)",351,46,-110
352,-110,45,1,1,True,"Rectangle(xy=(-110, 45), width=1, height=1, angle=0)",352,46,-109
353,-109,45,1,1,True,"Rectangle(xy=(-109, 45), width=1, height=1, angle=0)",353,46,-108
354,-108,45,8,1,True,"Rectangle(xy=(-108, 45), width=8, height=1, angle=0)",354,46,-100
355,-100,45,4,1,True,"Rectangle(xy=(-100, 45), width=4, height=1, angle=0)",355,46,-96
356,-96,45,1,1,True,"Rectangle(xy=(-96, 45), width=1, height=1, angle=0)",356,46,-95
357,-95,45,1,1,True,"Rectangle(xy=(-95, 45), width=1, height=1, angle=0)",357,46,-94
358,-94,45,1,1,True,"Rectangle(xy=(-94, 45), width=1, height=1, angle=0)",358,46,-93
359,-93,45,1,1,True,"Rectangle(xy=(-93, 45), width=1, height=1, angle=0)",359,46,-92
360,-92,45,1,1,True,"Rectangle(xy=(-92, 45), width=1, height=1, angle=0)",360,46,-91
361,-91,45,1,1,True,"Rectangle(xy=(-91, 45), width=1, height=1, angle=0)",361,46,-90
362,-90,45,1,1,True,"Rectangle(xy=(-90, 45), width=1, height=1, angle=0)",362,46,-89
363,-89,45,1,1,True,"Rectangle(xy=(-89, 45), width=1, height=1, angle=0)",363,46,-88
364,-88,45,1,1,True,"Rectangle(xy=(-88, 45), width=1, height=1, angle=0)",364,46,-87
365,-87,45,1,1,True,"Rectangle(xy=(-87, 45), width=1, height=1, angle=0)",365,46,-86
366,-86,45,1,1,True,"Rectangle(xy=(-86, 45), width=1, height=1, angle=0)",366,46,-85
367,-85,45,1,1,True,"Rectangle(xy=(-85, 45), width=1, height=1, angle=0)",367,46,-84
368,-84,45,1,1,True,"Rectangle(xy=(-84, 45), width=1, height=1, angle=0)",368,46,-83
369,-83,45,1,1,True,"Rectangle(xy=(-83, 45), width=1, height=1, angle=0)",369,46,-82
370,-82,45,1,1,True,"Rectangle(xy=(-82, 45), width=1, height=1, angle=0)",370,46,-81
371,-81,45,1,1,True,"Rectangle(xy=(-81, 45), width=1, height=1, angle=0)",371,46,-80
372,-80,45,1,1,True,"Rectangle(xy=(-80, 45), width=1, height=1, angle=0)",372,46,-79
373,-79,45,1,1,True,"Rectangle(xy=(-79, 45), width=1, height=1, angle=0)",373,46,-78
374,-78,45,1,1,True,"Rectangle(xy=(-78, 45), width=1, height=1, angle=0)",374,46,-77
375,-77,45,1,1,True,"Rectangle(xy=(-77, 45), width=1, height=1, angle=0)",375,46,-76
376,-76,45,1,1,True,"Rectangle(xy=(-76, 45), width=1, height=1, angle=0)",376,46,-75
377,-75,45,1,1,True,"Rectangle(xy=(-75, 45), width=1, height=1, angle=0)",377,46,-74
378,-74,45,1,1,True,"Rectangle(xy=(-74, 45), width=1, height=1, angle=0)",378,46,-73
379,-73,45,21,1,True,"Rectangle(xy=(-73, 45), width=21, height=1, angle=0)",379,46,-52
380,-177,46,54,1,True,"Rectangle(xy=(-177, 46), width=54, height=1, angle=0)",380,47,-123
381,-123,46,4,1,True,"Rectangle(xy=(-123, 46), width=4, height=1, angle=0)",381,47,-119
382,-119,46,4,1,True,"Rectangle(xy=(-119, 46), width=4, height=1, angle=0)",382,47,-115
383,-115,46,1,1,True,"Rectangle(xy=(-115, 46), width=1, height=1, angle=0)",383,47,-114
384,-114,46,1,1,True,"Rectangle(xy=(-114, 46), width=1, height=1, angle=0)",384,47,-113
385,-113,46,1,1,True,"Rectangle(xy=(-113, 46), width=1, height=1, angle=0)",385,47,-112
386,-112,46,1,1,True,"Rectangle(xy=(-112, 46), width=1, height=1, angle=0)",386,47,-111
387,-111,46,1,1,True,"Rectangle(xy=(-111, 46), width=1, height=1, angle=0)",387,47,-110
388,-110,46,1,1,True,"Rectangle(xy=(-110, 46), width=1, height=1, angle=0)",388,47,-109
389,-109,46,1,1,True,"Rectangle(xy=(-109, 46), width=1, height=1, angle=0)",389,47,-108
390,-108,46,8,1,True,"Rectangle(xy=(-108, 46), width=8, height=1, angle=0)",390,47,-100
391,-100,46,4,1,True,"Rectangle(xy=(-100, 46), width=4, height=1, angle=0)",391,47,-96
392,-96,46,1,1,True,"Rectangle(xy=(-96, 46), width=1, height=1, angle=0)",392,47,-95
393,-95,46,1,1,True,"Rectangle(xy=(-95, 46), width=1, height=1, angle=0)",393,47,-94
394,-94,46,1,1,True,"Rectangle(xy=(-94, 46), width=1, height=1, angle=0)",394,47,-93
395,-93,46,1,1,True,"Rectangle(xy=(-93, 46), width=1, height=1, angle=0)",395,47,-92
396,-92,46,1,1,True,"Rectangle(xy=(-92, 46), width=1, height=1, angle=0)",396,47,-91
397,-91,46,1,1,True,"Rectangle(xy=(-91, 46), width=1, height=1, angle=0)",397,47,-90
398,-90,46,1,1,True,"Rectangle(xy=(-90, 46), width=1, height=1, angle=0)",398,47,-89
399,-89,46,1,1,True,"Rectangle(xy=(-89, 46), width=1, height=1, angle=0)",399,47,-88
400,-88,46,1,1,True,"Rectangle(xy=(-88, 46), width=1, height=1, angle=0)",400,47,-87
401,-87,46,1,1,True,"Rectangle(xy=(-87, 46), width=1, height=1, angle=0)",401,47,-86
402,-86,46,1,1,True,"Rectangle(xy=(-86, 46), width=1, height=1, angle=0)",402,47,-85
403,-85,46,1,1,True,"Rectangle(xy=(-85, 46), width=1, height=1, angle=0)",403,47,-84
404,-84,46,1,1,True,"Rectangle(xy=(-84, 46), width=1, height=1, angle=0)",404,47,-83
405,-83,46,1,1,True,"Rectangle(xy=(-83, 46), width=1, height=1, angle=0)",405,47,-82
406,-82,46,1,1,True,"Rectangle(xy=(-82, 46), width=1, height=1, angle=0)",406,47,-81
407,-81,46,1,1,True,"Rectangle(xy=(-81, 46), width=1, height=1, angle=0)",407,47,-80
408,-80,46,1,1,True,"Rectangle(xy=(-80, 46), width=1, height=1, angle=0)",408,47,-79
409,-79,46,4,1,True,"Rectangle(xy=(-79, 46), width=4, height=1, angle=0)",409,47,-75
410,-75,46,2,1,True,"Rectangle(xy=(-75, 46), width=2, height=1, angle=0)",410,47,-73
411,-73,46,1,1,True,"Rectangle(xy=(-73, 46), width=1, height=1, angle=0)",411,47,-72
412,-72,46,1,1,True,"Rectangle(xy=(-72, 46), width=1, height=1, angle=0)",412,47,-71
413,-71,46,19,1,True,"Rectangle(xy=(-71, 46), width=19, height=1, angle=0)",413,47,-52
414,-177,47,55,1,True,"Rectangle(xy=(-177, 47), width=55, height=1, angle=0)",414,48,-122
415,-122,47,3,1,True,"Rectangle(xy=(-122, 47), width=3, height=1, angle=0)",415,48,-119
416,-119,47,5,1,True,"Rectangle(xy=(-119, 47), width=5, height=1, angle=0)",416,48,-114
417,-114,47,1,1,True,"Rectangle(xy=(-114, 47), width=1, height=1, angle=0)",417,48,-113
418,-113,47,1,1,True,"Rectangle(xy=(-113, 47), width=1, height=1, angle=0)",418,48,-112
419,-112,47,1,1,True,"Rectangle(xy=(-112, 47), width=1, height=1, angle=0)",419,48,-111
420,-111,47,2,1,True,"Rectangle(xy=(-111, 47), width=2, height=1, angle=0)",420,48,-109
421,-109,47,8,1,True,"Rectangle(xy=(-109, 47), width=8, height=1, angle=0)",421,48,-101
422,-101,47,4,1,True,"Rectangle(xy=(-101, 47), width=4, height=1, angle=0)",422,48,-97
423,-97,47,1,1,True,"Rectangle(xy=(-97, 47), width=1, height=1, angle=0)",423,48,-96
424,-96,47,1,1,True,"Rectangle(xy=(-96, 47), width=1, height=1, angle=0)",424,48,-95
425,-95,47,1,1,True,"Rectangle(xy=(-95, 47), width=1, height=1, angle=0)",425,48,-94
426,-94,47,2,1,True,"Rectangle(xy=(-94, 47), width=2, height=1, angle=0)",426,48,-92
427,-92,47,2,1,True,"Rectangle(xy=(-92, 47), width=2, height=1, angle=0)",427,48,-90
428,-90,47,2,1,True,"Rectangle(xy=(-90, 47), width=2, height=1, angle=0)",428,48,-88
429,-88,47,1,1,True,"Rectangle(xy=(-88, 47), width=1, height=1, angle=0)",429,48,-87
430,-87,47,4,1,True,"Rectangle(xy=(-87, 47), width=4, height=1, angle=0)",430,48,-83
431,-83,47,4,1,True,"Rectangle(xy=(-83, 47), width=4, height=1, angle=0)",431,48,-79
432,-79,47,27,1,True,"Rectangle(xy=(-79, 47), width=27, height=1, angle=0)",432,48,-52
433,-177,48,53,1,True,"Rectangle(xy=(-177, 48), width=53, height=1, angle=0)",433,49,-124
434,-124,48,1,1,True,"Rectangle(xy=(-124, 48), width=1, height=1, angle=0)",434,49,-123
435,-123,48,2,1,True,"Rectangle(xy=(-123, 48), width=2, height=1, angle=0)",435,49,-121
436,-121,48,7,1,True,"Rectangle(xy=(-121, 48), width=7, height=1, angle=0)",436,49,-114
437,-114,48,2,1,True,"Rectangle(xy=(-114, 48), width=2, height=1, angle=0)",437,49,-112
438,-112,48,8,1,True,"Rectangle(xy=(-112, 48), width=8, height=1, angle=0)",438,49,-104
439,-104,48,2,1,True,"Rectangle(xy=(-104, 48), width=2, height=1, angle=0)",439,49,-102
440,-102,48,1,1,True,"Rectangle(xy=(-102, 48), width=1, height=1, angle=0)",440,49,-101
441,-101,48,4,1,True,"Rectangle(xy=(-101, 48), width=4, height=1, angle=0)",441,49,-97
442,-97,48,1,1,True,"Rectangle(xy=(-97, 48), width=1, height=1, angle=0)",442,49,-96
443,-96,48,1,1,True,"Rectangle(xy=(-96, 48), width=1, height=1, angle=0)",443,49,-95
444,-95,48,1,1,True,"Rectangle(xy=(-95, 48), width=1, height=1, angle=0)",444,49,-94
445,-94,48,1,1,True,"Rectangle(xy=(-94, 48), width=1, height=1, angle=0)",445,49,-93
446,-93,48,4,1,True,"Rectangle(xy=(-93, 48), width=4, height=1, angle=0)",446,49,-89
447,-89,48,1,1,True,"Rectangle(xy=(-89, 48), width=1, height=1, angle=0)",447,49,-88
448,-88,48,2,1,True,"Rectangle(xy=(-88, 48), width=2, height=1, angle=0)",448,49,-86
449,-86,48,5,1,True,"Rectangle(xy=(-86, 48), width=5, height=1, angle=0)",449,49,-81
450,-81,48,1,1,True,"Rectangle(xy=(-81, 48), width=1, height=1, angle=0)",450,49,-80
451,-80,48,1,1,True,"Rectangle(xy=(-80, 48), width=1, height=1, angle=0)",451,49,-79
452,-79,48,1,1,True,"Rectangle(xy=(-79, 48), width=1, height=1, angle=0)",452,49,-78
453,-78,48,1,1,True,"Rectangle(xy=(-78, 48), width=1, height=1, angle=0)",453,49,-77
454,-77,48,5,1,True,"Rectangle(xy=(-77, 48), width=5, height=1, angle=0)",454,49,-72
455,-72,48,1,1,True,"Rectangle(xy=(-72, 48), width=1, height=1, angle=0)",455,49,-71
456,-71,48,1,1,True,"Rectangle(xy=(-71, 48), width=1, height=1, angle=0)",456,49,-70
457,-70,48,1,1,True,"Rectangle(xy=(-70, 48), width=1, height=1, angle=0)",457,49,-69
458,-69,48,17,1,True,"Rectangle(xy=(-69, 48), width=17, height=1, angle=0)",458,49,-52
459,-177,49,52,1,True,"Rectangle(xy=(-177, 49), width=52, height=1, angle=0)",459,50,-125
460,-125,49,1,1,True,"Rectangle(xy=(-125, 49), width=1, height=1, angle=0)",460,50,-124
461,-124,49,1,1,True,"Rectangle(xy=(-124, 49), width=1, height=1, angle=0)",461,50,-123
462,-123,49,1,1,True,"Rectangle(xy=(-123, 49), width=1, height=1, angle=0)",462,50,-122
463,-122,49,3,1,True,"Rectangle(xy=(-122, 49), width=3, height=1, angle=0)",463,50,-119
464,-119,49,3,1,True,"Rectangle(xy=(-119, 49), width=3, height=1, angle=0)",464,50,-116
465,-116,49,1,1,True,"Rectangle(xy=(-116, 49), width=1, height=1, angle=0)",465,50,-115
466,-115,49,1,1,True,"Rectangle(xy=(-115, 49), width=1, height=1, angle=0)",466,50,-114
467,-114,49,1,1,True,"Rectangle(xy=(-114, 49), width=1, height=1, angle=0)",467,50,-113
468,-113,49,12,1,True,"Rectangle(xy=(-113, 49), width=12, height=1, angle=0)",468,50,-101
469,-101,49,1,1,True,"Rectangle(xy=(-101, 49), width=1, height=1, angle=0)",469,50,-100
470,-100,49,2,1,True,"Rectangle(xy=(-100, 49), width=2, height=1, angle=0)",470,50,-98
471,-98,49,1,1,True,"Rectangle(xy=(-98, 49), width=1, height=1, angle=0)",471,50,-97
472,-97,49,1,1,True,"Rectangle(xy=(-97, 49), width=1, height=1, angle=0)",472,50,-96
473,-96,49,1,1,True,"Rectangle(xy=(-96, 49), width=1, height=1, angle=0)",473,50,-95
474,-95,49,14,1,True,"Rectangle(xy=(-95, 49), width=14, height=1, angle=0)",474,50,-81
475,-81,49,4,1,True,"Rectangle(xy=(-81, 49), width=4, height=1, angle=0)",475,50,-77
476,-77,49,25,1,True,"Rectangle(xy=(-77, 49), width=25, height=1, angle=0)",476,50,-52
477,-177,50,57,1,True,"Rectangle(xy=(-177, 50), width=57, height=1, angle=0)",477,51,-120
478,-120,50,1,1,True,"Rectangle(xy=(-120, 50), width=1, height=1, angle=0)",478,51,-119
479,-119,50,4,1,True,"Rectangle(xy=(-119, 50), width=4, height=1, angle=0)",479,51,-115
480,-115,50,2,1,True,"Rectangle(xy=(-115, 50), width=2, height=1, angle=0)",480,51,-113
481,-113,50,8,1,True,"Rectangle(xy=(-113, 50), width=8, height=1, angle=0)",481,51,-105
482,-105,50,1,1,True,"Rectangle(xy=(-105, 50), width=1, height=1, angle=0)",482,51,-104
483,-104,50,2,1,True,"Rectangle(xy=(-104, 50), width=2, height=1, angle=0)",483,51,-102
484,-102,50,3,1,True,"Rectangle(xy=(-102, 50), width=3, height=1, angle=0)",484,51,-99
485,-99,50,1,1,True,"Rectangle(xy=(-99, 50), width=1, height=1, angle=0)",485,51,-98
486,-98,50,1,1,True,"Rectangle(xy=(-98, 50), width=1, height=1, angle=0)",486,51,-97
487,-97,50,1,1,True,"Rectangle(xy=(-97, 50), width=1, height=1, angle=0)",487,51,-96
488,-96,50,1,1,True,"Rectangle(xy=(-96, 50), width=1, height=1, angle=0)",488,51,-95
489,-95,50,43,1,True,"Rectangle(xy=(-95, 50), width=43, height=1, angle=0)",489,51,-52
490,-177,51,53,1,True,"Rectangle(xy=(-177, 51), width=53, height=1, angle=0)",490,52,-124
491,-124,51,2,1,True,"Rectangle(xy=(-124, 51), width=2, height=1, angle=0)",491,52,-122
492,-122,51,1,1,True,"Rectangle(xy=(-122, 51), width=1, height=1, angle=0)",492,52,-121
493,-121,51,1,1,True,"Rectangle(xy=(-121, 51), width=1, height=1, angle=0)",493,52,-120
494,-120,51,3,1,True,"Rectangle(xy=(-120, 51), width=3, height=1, angle=0)",494,52,-117
495,-117,51,3,1,True,"Rectangle(xy=(-117, 51), width=3, height=1, angle=0)",495,52,-114
496,-114,51,8,1,True,"Rectangle(xy=(-114, 51), width=8, height=1, angle=0)",496,52,-106
497,-106,51,1,1,True,"Rectangle(xy=(-106, 51), width=1, height=1, angle=0)",497,52,-105
498,-105,51,4,1,True,"Rectangle(xy=(-105, 51), width=4, height=1, angle=0)",498,52,-101
499,-101,51,4,1,True,"Rectangle(xy=(-101, 51), width=4, height=1, angle=0)",499,52,-97
500,-97,51,1,1,True,"Rectangle(xy=(-97, 51), width=1, height=1, angle=0)",500,52,-96
501,-96,51,44,1,True,"Rectangle(xy=(-96, 51), width=44, height=1, angle=0)",501,52,-52
502,-177,52,55,1,True,"Rectangle(xy=(-177, 52), width=55, height=1, angle=0)",502,53,-122
503,-122,52,4,1,True,"Rectangle(xy=(-122, 52), width=4, height=1, angle=0)",503,53,-118
504,-118,52,8,1,True,"Rectangle(xy=(-118, 52), width=8, height=1, angle=0)",504,53,-110
505,-110,52,4,1,True,"Rectangle(xy=(-110, 52), width=4, height=1, angle=0)",505,53,-106
506,-106,52,54,1,True,"Rectangle(xy=(-106, 52), width=54, height=1, angle=0)",506,53,-52
507,-177,53,55,1,True,"Rectangle(xy=(-177, 53), width=55, height=1, angle=0)",507,54,-122
508,-122,53,8,1,True,"Rectangle(xy=(-122, 53), width=8, height=1, angle=0)",508,54,-114
509,-114,53,1,1,True,"Rectangle(xy=(-114, 53), width=1, height=1, angle=0)",509,54,-113
510,-113,53,1,1,True,"Rectangle(xy=(-113, 53), width=1, height=1, angle=0)",510,54,-112
511,-112,53,7,1,True,"Rectangle(xy=(-112, 53), width=7, height=1, angle=0)",511,54,-105
512,-105,53,53,1,True,"Rectangle(xy=(-105, 53), width=53, height=1, angle=0)",512,54,-52
513,-177,54,55,1,True,"Rectangle(xy=(-177, 54), width=55, height=1, angle=0)",513,55,-122
514,-122,54,10,1,True,"Rectangle(xy=(-122, 54), width=10, height=1, angle=0)",514,55,-112
515,-112,54,60,1,True,"Rectangle(xy=(-112, 54), width=60, height=1, angle=0)",515,55,-52
516,-177,55,54,1,True,"Rectangle(xy=(-177, 55), width=54, height=1, angle=0)",516,56,-123
517,-123,55,8,1,True,"Rectangle(xy=(-123, 55), width=8, height=1, angle=0)",517,56,-115
518,-115,55,63,1,True,"Rectangle(xy=(-115, 55), width=63, height=1, angle=0)",518,56,-52
519,-177,56,57,1,True,"Rectangle(xy=(-177, 56), width=57, height=1, angle=0)",519,57,-120
520,-120,56,68,1,True,"Rectangle(xy=(-120, 56), width=68, height=1, angle=0)",520,57,-52
521,-177,57,125,1,True,"Rectangle(xy=(-177, 57), width=125, height=1, angle=0)",521,58,-52
522,-177,58,21,1,True,"Rectangle(xy=(-177, 58), width=21, height=1, angle=0)",522,59,-156
523,-156,58,21,1,True,"Rectangle(xy=(-156, 58), width=21, height=1, angle=0)",523,59,-135
524,-135,58,32,1,True,"Rectangle(xy=(-135, 58), width=32, height=1, angle=0)",524,59,-103
525,-103,58,9,1,True,"Rectangle(xy=(-103, 58), width=9, height=1, angle=0)",525,59,-94
526,-94,58,42,1,True,"Rectangle(xy=(-94, 58), width=42, height=1, angle=0)",526,59,-52
527,-177,59,19,1,True,"Rectangle(xy=(-177, 59), width=19, height=1, angle=0)",527,60,-158
528,-158,59,106,1,True,"Rectangle(xy=(-158, 59), width=106, height=1, angle=0)",528,60,-52
529,-177,60,26,1,True,"Rectangle(xy=(-177, 60), width=26, height=1, angle=0)",529,61,-151
530,-151,60,2,1,True,"Rectangle(xy=(-151, 60), width=2, height=1, angle=0)",530,61,-149
531,-149,60,4,1,True,"Rectangle(xy=(-149, 60), width=4, height=1, angle=0)",531,61,-145
532,-145,60,16,1,True,"Rectangle(xy=(-145, 60), width=16, height=1, angle=0)",532,61,-129
533,-129,60,14,1,True,"Rectangle(xy=(-129, 60), width=14, height=1, angle=0)",533,61,-115
534,-115,60,63,1,True,"Rectangle(xy=(-115, 60), width=63, height=1, angle=0)",534,61,-52
535,-177,61,26,1,True,"Rectangle(xy=(-177, 61), width=26, height=1, angle=0)",535,62,-151
536,-151,61,1,1,True,"Rectangle(xy=(-151, 61), width=1, height=1, angle=0)",536,62,-150
537,-150,61,1,1,True,"Rectangle(xy=(-150, 61), width=1, height=1, angle=0)",537,62,-149
538,-149,61,97,1,True,"Rectangle(xy=(-149, 61), width=97, height=1, angle=0)",538,62,-52
539,-177,62,27,1,True,"Rectangle(xy=(-177, 62), width=27, height=1, angle=0)",539,63,-150
540,-150,62,32,1,True,"Rectangle(xy=(-150, 62), width=32, height=1, angle=0)",540,63,-118
541,-118,62,66,1,True,"Rectangle(xy=(-118, 62), width=66, height=1, angle=0)",541,63,-52
542,-177,63,6,1,True,"Rectangle(xy=(-177, 63), width=6, height=1, angle=0)",542,64,-171
543,-171,63,28,1,True,"Rectangle(xy=(-171, 63), width=28, height=1, angle=0)",543,64,-143
544,-143,63,91,1,True,"Rectangle(xy=(-143, 63), width=91, height=1, angle=0)",544,64,-52
545,-177,64,12,1,True,"Rectangle(xy=(-177, 64), width=12, height=1, angle=0)",545,65,-165
546,-165,64,1,1,True,"Rectangle(xy=(-165, 64), width=1, height=1, angle=0)",546,65,-164
547,-164,64,16,1,True,"Rectangle(xy=(-164, 64), width=16, height=1, angle=0)",547,65,-148
548,-148,64,1,1,True,"Rectangle(xy=(-148, 64), width=1, height=1, angle=0)",548,65,-147
549,-147,64,95,1,True,"Rectangle(xy=(-147, 64), width=95, height=1, angle=0)",549,65,-52
550,-177,65,125,1,True,"Rectangle(xy=(-177, 65), width=125, height=1, angle=0)",550,66,-52
551,-177,66,125,1,True,"Rectangle(xy=(-177, 66), width=125, height=1, angle=0)",551,67,-52
552,-177,67,125,1,True,"Rectangle(xy=(-177, 67), width=125, height=1, angle=0)",552,68,-52
553,-177,70,27,1,True,"Rectangle(xy=(-177, 70), width=27, height=1, angle=0)",553,71,-150
554,-150,70,2,1,True,"Rectangle(xy=(-150, 70), width=2, height=1, angle=0)",554,71,-148
555,-148,70,96,1,True,"Rectangle(xy=(-148, 70), width=96, height=1, angle=0)",555,71,-52
556,-177,71,125,1,True,"Rectangle(xy=(-177, 71), width=125, height=1, angle=0)",556,72,-52
557,-177,72,125,1,True,"Rectangle(xy=(-177, 72), width=125, height=1, angle=0)",557,73,-52
558,-177,68,39,2,True,"Rectangle(xy=(-177, 68), width=39, height=2, angle=0)",558,70,-138
559,-138,68,86,2,True,"Rectangle(xy=(-138, 68), width=86, height=2, angle=0)",559,70,-52
560,-177,21,125,4,True,"Rectangle(xy=(-177, 21), width=125, height=4, angle=0)",560,25,-52
561,-177,73,125,9,True,"Rectangle(xy=(-177, 73), width=125, height=9, angle=0)",561,82,-52
